9,9 
+++++++++
+s++    +
+ ++ ++ +
+ ++ ++ +
+ ++ ++ +
+ ++ ++ +
+ ++ ++ +
+    ++g+
+++++++++
